name|Identify the name of the element or attribute
value|Identify the value of the element or attribute
idtype|Identify the Identify type of the ID
prodtype|Identify the product type
linktype|Identify the type of relation between documents
link|Identify the relation between the documents
resptp|Identify the response type
specyear|Identify the year as presented in the reference. E.g.: 2005, c1900 (about 1900), 1800a, etc.
ccode|Identify the Identify where the markup is done
doctopic|Identify the type of the document
language|Identify the language
illustrative material type|Identify the illustrative material type existing in the document
version|Identify the version of the document
toccode|Identify the indicates whether the text title is present on the table of contents (title) or not (sectitle)
role|Identify the Role of the author
scheme|Identify the controlled vocabulary
keyword priority level|Identify the indicates the
standard|Identify the standard adopted by the journal
id|Identify an ID
rid|Identify an reference to an ID 
dateiso|Identify the date in format YYYYMMDD (YYYY = 4 digits for year, 2 digits for month, 2 digits for day)
count|Identify the quantity
pages|Identify the pagination
from|Identify the start date
to|Identify the due date
sponsor|Identify the funding institution
no|Identify the number
orgname|Identify the organization name
orgdiv1|Identify the organization division 1
orgdiv2|Identify the organization division 2
orgdiv3|Identify the organization division 3
ctdbid|Identify the clinical trial database ID
country|Identify the country
deposid|Identify the repository ID
entrdate|Identify the entrance date
embdate|Identify the embargo date
doctype|Identify the type of the document
cturl|Identify the clinical trial database's URL
ftype|Identify the type of the figure
lictype|Identify the license type
href|Identify the href of a file
pubtype|Identify the publication type
hcomment|Identify the permission to comment or not the document
filename|Identify the filename of a figure or table or equation
ref-type|Identify the type of the reference
sec-type|Identify the type of the section
listtype|Identify the type of the list
fntype|Identify the footnote type
blcktype|Identify the text block type
corresp|Identify the correspondence information
eqcontr|Identify the equality information
deceased|Identify the deceased author
